PPPPPPPPPPPPPPPPPPPPPPPPPPPPPPP
ECCCCCCCCCCCCCCCCCGCCCCCCCPOPCS
PCPPPPPPPPPPPPPPPPPPPPPPPPPCPCP
PCCCCCCCCCCCOCCCCCCCCCCCCCPCPCP
PCPPPPPPPPPPPPPPPPPPPPPPPPPCPCP
PCCCCCCCCCCCGCCCCCCCCCCCCCPOPCP
PCPPPPPPPPPPPPPPPPPPPPPPPPPCPCP
PCCCCCCCCCCCCCCCCCCCCCCCCCPOPCP
PCPPPPPPPPPPPPPPPPPPPPPPPCPCPCP
PCCCCCCCCCCCCCCCCCCCCCCCPCPOPCP
PCPPPPPPPPPPPPPPPPPPPPPPPCPCPCP
PCCCCCCCOCCCCCCCCCCCCCCCPCPOPCP
PCPPPPPPPPPPPPPPPPPPPPPPPCPPPCP
PCCCCCCCCCCCCCGCCCCCKCCCPCCCCCP
PPPPPPPPPPPPPPPPPPPPPPPPPPPPPPP