PPPPPPPPPPPPPPPPPPPP
ECCCCCCCCCCCCCCCCCCP
PPCPPPPPPPPPPPPPPPCP
PPCCCCPPPPPPPPPPPPCP
PPCPPCPPPCCCCCCGCCCP
PPCPPCPPPCPPPCPPPPCP
PPCPPOPPPCPPPCPPPPCP
PPCPPCPPPCPPPCPPPPCP
PPCCCCCCCCPPPCCCKPCS
PPPPPPPPPPPPPPPPPPPP